NO ./textures/no_texture/no.xpm
SO ./textures/so_texture/so.xpm
WE ./textures/we_texture/we.xpm
EA ./textures/ea_texture/ea.xpm
DC ./textures/doors_texture/closed.xpm
DO ./textures/doors_texture/opened.xpm

F 220,100,30
C 45,			54,45

       1111111111111111111
   111100000000000000000001111
  10000000000000000000000000011      1
  10000111000000000000000000001   111011
1100001   10000000000000001111   1   1001
1000001    1000000000000001     101   101
10000001    10000000000001      100111001
1000001      111000000000111111110000000011
10000001111 	10000000000000D000000000001
100000000001    100000000000111111000000001
1000000000001  1000000000001      11100001
1000000000000110000000000001        10001
1000000000000000000000N0000011     10001
 111111000000000000000000000001111100001
	   11111111111100000000000011111111
                  1111111111111
